###########
####T######
####.######
####.######
####¹¹...T#
#T..¹@#####
#####¹#####
#####.#####
#####.#####
#####T#####
###########
