###########
####...####
##T@¹..####
####.¹T####
##T##¹..###
##.#.T#.###
##¹.#...###
##......###
###########
###########
###########