###########
###########
######@T###
####....###
####.¹¹..##
###...¹T.##
###T..#..##
###########
###########
###########
###########