kppkppppppk
kppkpPPPPPP
kpppPPP...P
kPPPP...P.P
pP.¹..P.P.P
pP.P..PTP.P
pP....P.P.P
pPPP...@P.P
pkP...P.P.P
pkPPPPP...P
pkppppPPPPP