###########
###########
#######...#
#####...#.#
##.¹..#.#.#
##.#..#T#.#
##....#.#.#
####...@#.#
###...#.#.#
#######...#
###########