######################
####T....#########..##
#.....##.#######.....#
#.#.#.##.####.....#..#
#...#.#..###.¹....#..#
##..#.....@....####..#
##..###...#.####.....#
###.......#........#.#
###..####.#.#####.##.#
#########.#..####.##..
#########....####.....
#########..######..###